%%%%%%%
%  G  %
% %%% %
% %. P%
% %%% %
%.    %
%%%%%%%
